error = Error
save = Salvar
edit = Editar
update = Actualizar
delete = Borrar
cancel = Cancelar
add_new = Agregar Nuevo
invalid_template = La plantilla: la plantilla no se ha encontrado.
menu = Menú
delete_confirmation.title = ¿Estás seguro?
delete_confirmation.msg = ¡No podrás recuperar este registro!
delete_confirmation.btn = Sí, eliminarlo!
delete.success = El registro ha sido eliminado con éxito
deleted = Eliminado
save.title = Salvado
save.msg = La información se ha guardado con éxito
tab.general = General
any = Cualquiera
sunday = Domingo
monday = Lunes
tuesday = Martes
wednesday = Miércoles
thursday = Jueves
friday = Viernes
saturday = Sábado
january = Enero
february = Febrero
march = Marzo
april = Abril
may = Mayo
june = Junio
july = Julio
august = Agosto
september = Septiembre
october = Octubre
november = Noviembre
december = Diciembre
none = Ninguno
select_one = -- Seleccione Uno --
xcr.google = Google
xcr.yahoo = Yahoo
xcr.bloomberg = Bloomberg
today = Hoy
yesterday = Ayer
last_week = La Semana Pasada
last_month = El Mes Pasado
last_year = El Año Pasado
custom = Personalizado
direction.out = Saliente
direction.in = Entrante
direction.loc = Local
direction.transit = Transito
select_all = Seleccionar Todo
remove_all = Eliminar Todo
this_month = Este Mes
this_year = Este Año
clear = Limpiar
remove = Eliminar
change = Modificar
browse = Explorar
this_week = Esta Semana
profile = Perfil
logout = Cerrar Sesión
day = Día|Días
week = Semana|Semanas
month = Mes|Meses
year = Año|Años
cannot_delete = No se puede eliminar este elemento porque está siendo utilizado por <b>:controller</b>
license.activation = Activación de Licencia
license.cannot_create_lic = Imposible crear la licencia
license.not_supported_by_os = Imposible registrar este serial, no compatible con este SO
license.server_error = No se puede activar la licencia provista
accept = Aceptar
clone = Clonar
warning = Advertencia
success = Éxito
action_not_implemented = La acción que intentas ejecutar no está implementada
select_all = Seleccionar Todo
remove_all = Eliminar Todo
dial = Dial
yes = Sí
no = No
extensions = Extensiones
queues = Colas
parking_lots = Parking Lots
conferences = Conferencias
trunks = Troncales
queued_calls = Llamadas en Cola
parking = Parking
profile = Perfil
logout = Cerrar Sesión
about = Acerca de
check_updates = Buscar Actualizaciones
close = Cerrar
app_version = Versión: <b>:ver</b>
updates = Actualizaciones
no_updates = No hay actualizaciones disponibles.
new_version = ¡La nueva versión <b>:app :ver</b> está disponible!
update_now = Actualizar Ahora
updating = Actualizando
update_error = No se Puede Actualizar
calls_history = Historial
calls_history.not_allowed = No esta autorizado a visualizar el historial de llamadas de la extensión seleccionada
number = Número
internal = Interna
outgoing = Saliente
incoming = Entrante
answered = Respondida
transit = Transito
busy = Ocupada
no_answer = No Respondida
failed = Fallida
unavailable = No Disponible
congestion = Congestionado
date_and_time = Hora y Fecha
today_calls = Llamadas de Hoy
call_type = Tipo de Llamada
caller_callee = Llamante/Llamado
duration = Duración
disposition = Disposición

